NO ./asset/north.xpm
SO ./asset/south.xpm
WE ./asset/west.xpm
EA ./asset/east.xpm

F 0,225,0
C 225,225,255

        1111111111111111111111111
        1000000000110000000000001
        1011000001110001111111111
        1001000000000011111111111
111111111011000001111111111111111
100000000011000001110111111111111
11110111111111011100000000001
11110111111111011101010010001
11000000110101011100000010001
10000000000000001100000010001
1000000000000000110101001N001
110000011101010111110111100111
11110111 1110101 101111010001
11111111 1111111 11111111111
